3 3 3 3 3 3 3 3 3 3
3 * * * * * * * * 3
3 * 1 + 1 1 + 1 * 3
3 * 1 S1 1 1 S1 1 * 3
3 * * P* * * P* * * 3
1 1 1 1 1 1 1 1 1 1
1 1 1 1 1 1 1 1 1 1
L3 3 3 3 3 3 3 3 3 L3