2 2 2 2 2 2 2 2 2 2
3 1 1 1 1 1 1 1 1 3
3 1 1 + 1 1 + 1 1 3
- - - 0 * * 0 - - -
3 1 1 P1 2 2 P1 1 1 3
3 1 1 1 1 1 1 1 1 3
L3 3 3 3 3 3 3 3 3 L3